11111111111111111
10C0000000C000001
10110110011111101
101101100111111C1
1011C11C000P01101
10110110011111101
10111111011111101
101111110110C0001
100C0110011111101
10E00110C11111101
10000C0000000C001
11111111111111111
