111111111111111
11100C1100011E1
111P00000C01101
100001101000001
111111111111111
