111111111111
111111111111
1P11C01110C1
101110C00001
1C0000001111
111111101111
111111100001
1E000C0010C1
111111111111
