111111111111111
11100C110001101
111P00000101101
100C0110010E001
111111111111111
